00000000000000000000000000000000000000000000000000000020000000
00000000000000000000000000000000000000000000000000000022000000
00000000000000000000000000000000000000000000000000000222000000
00000000000000000000000000000000000000000000000000022222000000
00000000000000000000000000000000000000000000000000222222000000
00000000000000000000000000000000000000000000000022222222200000
00000000000000000000000000000000000000000000000222222222200000
00000000000000000000000200000000000000000000002222222222200000
00000000000000000000000000000000000000000000222222222222200000
00000000000000000000000000000000000000000002222222222222220000
00000000000000000000000000000000000000000022222222222222220000
00000000000000000000000000000000000000002222222222222222220000
00000000000000000000000000000000000000022222222222222222220000
00000000000000000000000000000000000000000000000000000000011000
00000000000000000000000000000000000011111111111111111111111000
00000000000000000000000000000000000111111111111111111111111000
00000000000000000000000000000000011111111111111111111111111000
00000000000000000000000000000000111111111111111111111111111100
00000000000000000000000000000011111111111111111111111111111100
00000000000000000000000000000111111111111111111111111111111100
00000000000000000000000000001111111111111111111111111111111100
00000000000000000000000000111111111111111111111111111111111110
00000000000000000000000001111111111111111111111111111111111110
00000000000000000000000011111111111111111111111111111111111110
00000000000000000000001111111111111111111111111111111111111110
00000000000000000000011111111111111111111111111111111111111110
00000000000000000001111111111111111111111111111111111111111000
00000000000000000001111111111111111111111111111111111111100000
00000000000000000001111111111111111111111111111111111111000000
00000000000000000001111111111111111111111111111111111100000000
00000000000000000001111111111111111111111111111111110000000000
00000000000000000011111111111111111111111111111111100000000000
00000000000000000011111111111111111111111111111110000000000000
00000000000000000011111311111111111111111111111000000000000000
00000000000000000011111111111111111111111111110000000000000000
00000000000000000011111111111111111111111111000000000000000000
00000000000000000111111111111111111111111110000000000000000000
00000000000000000111111111111111111111111000000000000000000000
00000000000000000111111111111111111111100000000000000000000000
00000000000000000111111111111111111111000000000000000000000000
00000000000000000111111111111111111100000000000000000000000000
00000000000000001111111111111111110000000000000000000000000000
00000000000000001111111111111111111000000000000000000000000000
00000000000000001111111111111111111000000000000000000000000000
00000000000000001111111111111111111000000000000000000000000000
00000000000000001111111111111111111000000000000000000000000000
00000000000000011111111111111111111100000000000000000000000000
00000000000000011111111111111111111100000000000000000000000000
00000000000000011111111111111111111100000000000000000000000000
00000000000000011111111111111111111100000000000000000000000000
00000000000000011111111111111111111110000000000000000000000000
00000000000000111111111111111111111110000000000000000000000000
00000000000000111111111111111111111110000000000000000000000000
00000000000000111111111111111111111110000000000000000000000000
00000000000000111111111111111111111111000000000000000000000000
00000000000000111111111111111111111111000000000000000000000000
00000000000001111111111111111111111111000000000000000000000000
00000000000001111111111111111111111111000000000000000000000000
00000000000001111111111111111111111111100000000000000000000000
00000000000001111111111111111111111111100000000000000000000000
00000000000001111111111111111111111111100000000000000000000000
00000000000001111111111111111111111111100000000000000000000000
00000000000011111111111111111111111111100000000000000000000000
00000000000011111111111111111111111111100000000000000000000000
00000000000011111111111111111111111111100000000000000000000000
00000000000011111111111111111111111111000000000000000000000000
00000000000011121111111111111111111111000000000000000000000000
00000000000011111111111111111111111110000000000000000000000000
00000000000111111111111111111111111110000000000000000000000000
00000000000111111111111111111111111110000000000000000000000000
00000000000111111111111111111111111100000000000000000000000000
00000000000111111111111111111111111100000000000000000000000000
00000000000111111111111111111111111100000000000000000000000000
00000000000111111111111111111111111000000000000000000000000000
00000000001111121111111111111111111000000000000000000000000000
00000000001111111111111111111111111000000000000000000000000000
00000000001111111111111111111111110000000000000000000000000000
00000000001111111111111111111111110000000000000000000000000000
00000000001111111111111111111111110000000000000000000000000000
00000000001111111111111111111111100000000000000000000000000000
00000000011111111111111111111111100000000000000000000000000000
00000000011111111111111111111111100000000000000000000000000000
00000000011111111111111111111111000000000000000000000000000000
00000000011111111111111111111111000000000000000000000000000000
00000000011111111111111111111110000000000000000000000000000000
00000000011111111111111111111110000000000000000000000000000000
00000000011111111111111111111110000000000000000000000000000000
00000000111111121111111111111100000000000000000000000000000000
00000000111111111111111111111100000000000000000000000000000000
00000000111111111111111111111100000000000000000000000000000000
00000000111111111111111111111000000000000000000000000000000000
00000000111111111111111111111000000000000000000000000000000000
00000000111111111111111111111000000000000000000000000000000000
00000001111111111111111111110000000000000000000000000000000000
00000001111111111111111111110000000000000000000000000000000000
00000001111111111111111111110000000000000000000000000000000000
00000001111111121111111111100000000000000000000000000000000000
00000001111111111111111111100000000000000000000000000000000000
00000001111111111111111111100000000000000000000000000000000000
00000011111111111111111111000000000000000000000000000000000000
00000011111111111111111111000000000000000000000000000000000000
00000011111111111111111110000000000000000000000000000000000000
00000011111111111111111110000000000000000000000000000000000000
00000011111111211111111110000000000000000000000000000000000000
00000011111111111111111110000000000000000000000000000000000000
00000111111111111111111110000000000000000000000000000000000000
00000111111111111111111110000000000000000000000000000000000000
00000111111111111111111110000000000000000000000000000000000000
00000111111111111111111100000000000000000000000000000000000000
00000111111111111111111100000000000000000000000000000000000000
00000111111111111111111100000000000000000000000000000000000000
00000111111111211111111100000000000000000000000000000000000000
00001111111111111111111100000000000000000000000000000000000000
00001111111111111111111100000000000000000000000000000000000000
00001111111111111111111100000000000000000000000000000000000000
00001111111111111111111100000000000000000000000000000000000000
00001111111111111111111100000000000000000000000000000000000000
00001111111111111111111100000000000000000000000000000000000000
00011111111111111111111100000000000000000000000000000000000000
00011111111111111111111100000000000000000000000000000000000000
00011111111111211111111000000000000000000000000000000000000000
00011111111111111111111000000000000000000000000000000000000000
00011111111111111111111000000000000000000000000000000000000000
00011111111111121111111000000000000000000000000000000000000000
00111111111111111111111000000000000000000000000000000000000000
00111111111111111111111000000000000000000000000000000000000000
00111111111111111111111000000000000000000000000000000000000000
00111111111111111111111000000000000000000000000000000000000000
00111111111111111111111000000000000000000000000000000000000000
00111111111111131111111000000000000000000000000000000000000000
00111111111111111111111000000000000000000000000000000000000000
01111111111111111111110000000000000000000000000000000000000000
01111111111111111111110000000000000000000000000000000000000000
01111111111111111111110000000000000000000000000000000000000000
01111111111111111111110000000000000000000000000000000000000000
01111111111111111111110000000000000000000000000000000000000000
01111111111111121111110000000000000000000000000000000000000000
00000000000000000000000000000000000000000000000000000000000000
